################################################################
...............................................................#
...............................................................#
...............................................................#
...............................................................#
...............................................................#
##################........................######################
.................#...................##########................#
.................#.............................................#
.................#############.................................#
.............................#.................................#
#######......................#.................................#
.............................#.................................#
#............................#.................................#
.............................#